FOXA	21st Century F
TWOU	2U
MMM	3M
WUBA	58.com
ABT	Abbott Labs
ABBV	AbbVie
ANF	Abercrombie &
ACHN	Achillion Pharn
ATVI	Activision Blizz
ADBE	Adobe
AAP	Advance Auto |
AMD	Advanced Micr
AES	AES Corporatio
AFL	Aflac
A	Agilent Techno
AGNC	AGNC Investm
AIG	AIG
AL	Air Lease Corpe
APD	Air Products an
AKS	AK Steel Holdir
AKAM	Akamai Technc
AA	Alcoa
ALXN	Alexion Pharm:
BABA	Alibaba
ALGN	Align Technolo
ALLT	Allot Communi
MDRX	Allscripts Healt
ALL	Allstate
ALLY	Ally Financial
GOOGL	Alphabet (Clas:
GOOG	Alphabet (Clas:
AABA	Altaba
ATUS	Altice USA
MO	Altria
AMZN	Amazon
ABEV	Ambev
AMC	AMC
AAL	American Airlin
AXL	American Axle
AEO	American Eagle
AEP	American Elect
AXP	American Expre
AMH	American Hom
AMT	American Towe
COLD	Americold Real
AME	Ametek
AMGN	Amgen
FOLD	Amicus Therap
AMRX	Amneal Pharm:
APH	Amphenol
ADI	Analog Devices
PLAN	Anaplan
ANGI	ANGI Homeser
AU	AngloGold Ash:
NLY	Annaly Capital !
ANSS	Ansys
AM	Antero Midstre:
AR	Antero Resourc
ANTM	Anthem
AOS	AO Smith
APA	Apache
ARI	Apollo Comme
AAPL	Apple
AMAT	Applied Materiz
ATR	AptarGroup
ARMK	Aramark
ADM	Archer-Daniels:
ARNC	Arconic
ARCC	Ares Capital
ANET	Arista Network
ARR	ARMOUR Resid
ARQL	ArQule
ASNA	Ascena Retail C
ASML	ASML Holding
HOME	At Home Grouf
T	AT&T
ADSK	Autodesk
ATHM	Autohome
ADP	Automatic Dat:
AZO	AutoZone
AVLR	Avalara
AVB	AvalonBay Con
EQH	AXA Equitable |
AXTA	Axalta Coating
BTG	B2Gold Corpor:
BIDU	Baidu
BKR	Baker Hughes
BLL	Ball Corporatio
BBD	Banco Bradesc
BMA	Banco Macro
BSBR	Banco Santand
BAC	Bank of Americ
GOLD	Barrick Gold
BHC	Bausch Health
BAX	Baxter
BBAR	BBVA Banco Fr
BDX	Becton Dickins
BDC	Belden
BRKB	Berkshire Hath.
BBY	Best Buy
BYND	Beyond Meat
BHP	BHP Billiton
BIL	Bilibili
BIO	Bio-Rad Labora
BIIB	Biogen
BMRN	Biomarin Pharn
BITA	Bitauto Holding
BJ	BJ's Wholesale
BB	BlackBerry
BLK	BlackRock
BX	Blackstone
BK	BNY Mellon
BA	Boeing
BKNG	Booking
BAH	Booz Allen Han
BWA	BorgWarner
BSX	Boston Scientif
BOX	Box
BRFS	BRF
BMY	Bristol-Myers S
BMYRT	Bristol-Myers S
BRX	Brixmor Proper
AVGO	Broadcom
BAM	Brookfield Ass¢
BIP	Brookfield Infra
BEP	Brookfield Ren¢
BFB	Brown Forman
BG	Bunge
COG	Cabot Oil & Gas
CDNS	Cadence Desig
CZR	Caesars Entert
CRC	California Reso
CPE	Callon Petroleu
CAJ	Canon
COF	Capital One
CAH	Cardinal Health
CG	Carlyle Group
CCL	Carnival
CRZO	Carrizo Oil & G¢
CARS	Cars.com
CAT	Caterpillar
CBL	CBL & Associat
CBOE	CBOE Holdings
CBRE	CBRE Group
CELG	Celgene
CX	CEMEX S.A.B.
CVE	Cenovus Energ
CNC	Centene
CDEV	Centennial Res
CNP	CenterPoint En
CTL	CenturyLink
CERN	Cerner
CF	CF Industries H
SCHW	Charles Schwal
CHTR	Charter Comm
CHKP	Check Point So
SQM	Chemical & Mir
CC	Chemours Con
LNG	Cheniere Energ
CHK	Chesapeake En
CVX	Chevron
CHWY	Chewy
CHS	Chico's FAS
CIM	Chimera Invest
CHL	China Mobile
ZNH	China Southern
CMG	Chipotle Mexic
CIEN	Ciena Corporat
C	Cigna
XEC	Cimarex Energy
CTAS	Cintas
CSCO	Cisco
C	Citigroup
CFG	Citizens Financ
CTXS	Citrix Systems
CCO	Clear Channel (
CWEN	Clearway Energ
CLF	Cliffs Natural R
CLDR	Cloudera
NET	Cloudflare
CLVS	Clovis Oncolog
CME	CME Group (CI:
CNX	CNX Resources
KO	Coca-Cola
CDE	Coeur Mining
CGNX	Cognex Corpor
CTSH	Cognizant Tect
CL	Colgate-Palmo!
CLNY	Colony Capital
CMCSA	Comcast
CMA	Comerica
COMM	CommScope H
CYH	Community He
SBS	Companhia de
CIG	Companhia Ene
SID	Companhia Sid
BVN	Compaiiia de M
CAG	ConAgra Foods
CXO	Concho Resour
CNDT	Conduent
COP	ConocoPhillips
ED	Consolidated E
STZ	Constellation B
CLR	Continental Re:
GLW	Corning
CTVA	Corteva
COST	Costco Wholes
COTY	Coty
BAP	Credicorp
CROX	Crocs
CRWD	CrowdStrike
CCI	Crown Castle
CSX	CSX
CVS	CVS Health
CY	Cypress Semic
DAN	Dana Holding
DHR	Danaher
DDOG	Datadog
DVA	DaVita HealthC
DELL	Dell Technolog
DAL	Delta Air Lines
DNR	Denbury Resou
DVN	Devon Energy
DO	Diamond Offsh
DLR	Digital Realty T
APPS	Digital Turbine
DFS	Discover Finan
DISCA	Discovery Com
DISCK	Discovery Com
DISH	DISH Network
DHC	Diversified Hea
DOCU	DocusSign
DG	Dollar General
DLTR	Dollar Tree
D	Dominion Ener
DPZ	Domino's Pizza
DHI	DR Horton
DBX	Dropbox
DUK	Duke Energy
DRE	Duke Realty
DNKN	Dunkin' Brands
DD	DuPont
DXC	DXC Technolog
ETFC	E*Trade
EBAY	eBay
ECL	Ecolab
EIX	Edison Internat
EW	Edwards Lifesc
ELAN	Elanco Animal |
EGO	Eldorado Gold (
EA	Electronic Arts
ESI	Element Solutic
LLY	Eli Lilly
ERJ	Embraer
EMR	Emerson
ECA	Encana Corpor:
ET	Energy Transfe
ENIA	Enersis Americ
ENLC	EnLink Midstre
EPD	Enterprise Prod
EOG	EOG Resources
EQT	EQT Corporatio
EFX	Equifax
EQIX	Equinix
EQNR	Equinor
ETRN	Equitrans Mids
EQR	Equity Resident
EL	Estee Lauder
ETSY	Etsy
EB	Eventbrite
EVR	Evercore
XGN	Exagen
EXEL	Exelixis
EXC	Exelon
EXPE	Expedia
STAY	Extended Stay .
XOM	Exxon Mobil
FFIV	F5 Networks
FB	Facebook
FDS	FactSet Resear
FAST	Fastenal Comp
FDX	FedEx
RACE	Ferrari
FCAU	Fiat Chrysler
FITB	Fifth Third Ban
FEYE	FireEye
FHN	First Horizon N
AG	First Majestic ¢
FSLR	First Solar
FE	FirstEnergy
FIS	FIS
FISV	Fiserv
FIT	Fitbit
FVE	Five Star Senio
FVRR	Fiverr
FLT	FleetCor Techn
FLEX	Flextronics Inte
FLR	Fluor Corporati
FL	Foot Locker
F	Ford
FTNT	Fortinet
FTV	Fortive
BEN	Franklin Resou
FCX	Freeport
FREQ	Frequency The!
FTR	Frontier Comm
FSK	FS KKR Capital
GME	GameStop
GC	Gannett Co
GPS	GAP
IT	Gartner
GDS	GDS Holdings
GD	General Dynam
GE	General Electric
GIS	General Mills
GM	General Motors
GNTX	Gentex
GNW	Genworth Finar
GGB	Gerdau S.A.
GILD	Gilead Science:
GNL	Global Net Lea:
GLUU	Glu Mobile
GDDY	GoDaddy
GOL	Gol Intelligent /
GF	Gold Fields
GS	Goldman Sachs
GT	Goodyear
GPRO	GoPro
GPK	Graphic Packag
GO	Grocery Outlet
GRPN	Groupon
GRUB	GrubHub
GGAL	Grupo Financie
BSMX	Grupo Financie
SUPV	Grupo Supervie
TV	Grupo Televisa
GES	Guess
GPOR	Gulfport Energy
HRB	H&R Block
HAL	Halliburton
HBI	Hanesbrands
HOG	Harley-Davidso
HMY	Harmony Gold !
HIG	Hartford Financ
HAS	Hasbro
HCA	HCA Healthcar:
HDB	HDFC Bank.
HL	Hecla Mining C
HE	Heico
HSIC	Henry Schein
HLF	Herbalife
HTZ	Hertz
HES	Hess Corporati
HPE	Hewlett Packar
HEXO	Hexo Corp
HLT	Hilton
HGV	Hilton Grand V:
HIMX	Himax Technol
HFC	HollyFrontier
HOLX	Hologic
HD	Home Depot
HMC	Honda Motor
HON	Honeywell
HRL	Hormel Foods ¢
HST	Host Hotels & |
HPQ	HP
HTHT	Huazhu Group
HUBS	HubSpot
HUM	Humana
HBAN	Huntington Bar
HUN	Huntsman Corj
HCM	Hutchison Chin
HUYA	HUYA
H	Hyatt Hotels
IAG	lamgold Corp
IBM	IBM
IBN	ICICI Bank
IDXX	IDEXX Laboratc
IGMS	IGM Bioscience
ITW	Illinois Tool Wo
ILMN	lllumina
IMGN	ImmunoGen
INCY	Incyte
INFN	Infinera Corpor
INFY	Infosys
INTC	Intel
IBKR	Interactive Brol
ICE	Intercontinenta
IGT	International G
IP	International P:
IPG	Interpublic Gro
INTU	Intuit
ISRG	Intuitive Surgic
IVZ	Invesco
IVR	Invesco Mortg:
ISBC	Investors Banc
NVTA	Invitae Corpora
INVH	Invitation Hom
IQ	iQlyl
IRBT	iRobot
IRM	Iron Mountain
ITUB	Itad Unibanco
JNJ	J&J
JCP	J. C. Penney C¢
JBHT	J.B. Hunt
JKHY	Jack Henry & A
JD	JD.com
JEF	Jefferies Finan
JBLU	JetBlue Airway
JKS	Jinkosolar Holc
DE	John Deere
JPM	JPMorgan
JMIA	Jumia
JNPR	Juniper Netwol
KAR	KAR Auction S
K	Kellogg's
KDP	Keurig Dr Pepp!
KEY	KeyCorp.
KEYS	Keysight Techn
KMB	Kimberly-Clark
KIM	Kimco Realty C
KMI	Kinder Morgan
KGC	Kinross Gold C
KKR	KKR & Co
KNX	Knight-Swift Tr
KSS	Kohl's
KOS	Kosmos Energy
KHC	Kraft Heinz
KTOS	Kratos
KR	Kroger Co
KT	KT
LB	L Brands
LRCX	Lam Research
LPI	Laredo Petrolet
LVS	Las Vegas San(
LTM	LATAM Airlines
LSCC	Lattice Semico
LDOS	Leidos Holding
LEN	Lennar
LEVI	Levi Strauss &
LXRX	Lexicon Pharm:
LX	LexinFintech H
LPL	LG Display
FWONK	Liberty Media C
LYV	Live Nation Ent
LTHM	Livent
LKQ	LKQ
LMT	Lockheed Mart
LOMA	Loma Negra Cc
LOW	Lowe's
LTC	LTC Properties
LK	Luckin Coffee
LULU	Lululemon
LYFT	Lyft
M	Macy's
MRO	Marathon Qil C
MPC	Marathon Petrc
MAR	Marriott
MMC	Marsh & McLer
MRVL	Marvell Techno
MAS	Masco Corpora
MA	Mastercard
MTDR	Matador Resou
MTCH	Match Group
MAT	Mattel
MXIM	Maxim Integrat
MDR	McDermott Inte
MCD	McDonald’s
MUX	McEwen Minin
MPW	Medical Proper
MDT	Medtronic
MLCO	Melco Crown E|
MELI	MercadoLibre
MRK	Merck
MET	Metlife
MFA	MFA Financial
MTG	MGIC Investme
MGM	MGM Resorts
MIK	Michaels Comg
MCHP	Microchip Tech
MU	Micron Techno!
MSFT	Microsoft
MFG	Mizuho Financi
MBT	Mobile TeleSys
MOMO	Momo
MDLZ	Mondelez
MGI	MoneyGram
MNST	Monster
MCO	Moody's
MS	Morgan Stanley
MORN	Morningstar
MOS	Mosaic Compa
MS	Motorola Soluti
MPLX	MPLX LP
MUFG	MUFJ Financial
MUR	Murphy Oil Cor|
MYL	Mylan NV
NBR	Nabors Industr
NDAQ	Nasdaq OMX G
NOV	National Oilwel
NTCO	Natura Holding
NAVI	Navient Corpor
NKTR	Nektar Therape
NPTN	NeoPhotonics
NTAP	NetApp
NTES	NetEase
NFLX	Netflix
NBIX	Neurocrine Bio
NBEV	New Age Bever
EDU	New Oriental E¢
NRZ	New Residentiz
NYCB	New York Com
NYMT	New York Mort
NYT	New York Time
NWL	Newell Rubberr
NEM	Newmont Mini
NWSA	News Corporat
NEE	NextEra Energy
NKE	Nike
NIO	NIO
NOAH	Noah Holdings
NBL	Noble Energy
NMR	Nomura
JWN	Nordstrom
NSC	Norfolk Southe
NTRS	Northern Trust
NOC	Northrop Grum
NLOK	NortonLifeLock
NCLH	Norwegian Crul
NVCR	NovoCure
NRG	NRG Energy
NUE	Nucor
NTNX	Nutanix
NUVA	NuVasive
NVDA	Nvidia
ORLY	O'Reilly Auto P:
OAS	Oasis Petroleur
OXY	Occidental
ODP	Office Depot
OKTA	Okta
OLN	Olin
OMC	Omnicom Grou
ON	ON Semicondu
OKE	Oneok
OPK	Opko Health
ORCL	Oracle
ONVO	Organovo Hold!
OSTK	Overstock.com
PG	P&G
PCAR	Paccar
PD	Pagerduty
PANW	Palo Alto Netw:
PAM	Pampa Energia
PAAS	Pan American ¢
PH	Parker-Hannifir
PE	Parsley Energy
PTEN	Patterson-UTI |
PAYX	Paychex
PYPL	PayPal
PBF	PBF Energy
PTON	Peloton Interac
PBCT	People's United
PEP	PepsiCo
PBR	Petroleo Brasile
PFE	Pfizer
PCG	PG&E Corporat
PM	Philip Morris
PSX	Phillips 66
PDD	Pinduoduo Inc
PINS	Pinterest
PXD	Pioneer Natura
PBI	Pitney Bowes
PVTL	Pivotal Softwar
PAA	Plains All Amer
PLUG	Plug Power
PS	Pluralsight
PNC	PNC Financial
PPG	PPG Industries
PPL	PPL Corporatio
PBH	Prestige Brand:
PRI	Primerica
PGR	Progressive
PLD	Prologis
PFPT	Proofpoint
PRU	Prudential Fina
PEG	Public Service |
PSA	Public Storage
PHM	PulteGroup
PSTG	Pure Storage
QTWO	Q2 Holdings
QEP	QEP Resources
QCOM	Qualcomm
QLYS	Qualys
PWR	Quanta Service
QD	Qudian
QRTEA	Qurate Retail
RL	Ralph Lauren
RRC	Range Resourc
RTN	Raytheon Com)j
RLGY	Realogy Holdin
REAL	RealReal
O	Realty Income
REGN	Regeneron Pha
RF	Regions Financ
REGI	Renewable Ene
RMD	ResMed
QSR	Restaurant Bral
RNG	RingCentral
RAD	Rite Aid
ROK	Rockwell Autor
ROKU	Roku
ROST	Ross Stores
RY	Royal Bank of (
RCL	Royal Caribbea
RES	RPC
SPGI	S&P
CRM	Salesforce
SBH	Sally Beauty
SGMO	Sangamo Ther:
SLB	Schlumberger
STX	Seagate Techn
SRE	Sempra Energy
SENS	Senseonics Ho
SHAK	Shake Shack
SHW	Sherwin-Willian
SHOP	Shopify
SBGL	Sibanye Gold L
SPG	Simon Property
SIRI	Sirius XM
SKX	Skechers
SWKS	Skyworks Soluf
WORK	Slack
SLM	SLM Corporatic
SM	SM Energy Con
SMAR	Smartsheet
SNAP	Snap
SOGO	Sogou
SNE	Sony
BID	Sotheby's
SO	Southern Comg
SCCO	Southern Copp
LUV	Southwest Airli
SWN	Southwestern
ONCE	Spark Therapet
SPLK	Splunk
SPOT	Spotify
S	Sprint Corporat
SFM	Sprouts Farmel
SQ	Square
SRCI	SRC Energy
SSNC	SS&C Technolo
SWK	Stanley Black &
SBUX	Starbucks
TSG	Stars Group
STT	State Street
STLD	Steel Dynamics
SFIX	Stitch Fix
STNE	StoneCo
SYK	Stryker
SMFG	Sumitomo Mits
SU	Suncor Energy
SPWR	SunPower
RUN	Sunrun
STI	SunTrust Bank:
SSSS	Sutter Rock Ca|
SYF	Synchrony Fina
SNPS	Synopsys
SYY	Sysco
TMUS	T-Mobile
TROW	T. Rowe Price
TTWO	T2 Interactive
TLRD	Tailored Brands
TSM	Taiwan Semico
TAK	Takeda Pharme
TAL	Tal Education C
SKT	Tanger Factory
TPR	Tapestry
TEDU	Tarena Internat
TRGP	Targa Resource
TGT	Target
TTM	Tata Motors
AMTD	TD Ameritrade
FTI	TechnipFMC pl
TECK	Teck Resource!
TFX	Teleflex
VIV	Telefonica Bras
TELL	Tellurian
TPX	Tempur Sealy
TME	Tencent Music
TER	Teradyne
TSLA	Tesla
TEVA	Teva Pharmace
TXN	Texas Instrume
DOW	The Dow Chem
GEO	The GEO Group
TXMD	TherapeuticsM
TMO	Thermo Fisher
TIF	Tiffany & Co
TSU	TIM Participagt
TIX	TJX Companies
D	Toronto-Domin
TM	Toyota
TW	Tradeweb Mark
TRXC	TransEnterix
TRV	Travelers
TCOM	Trip.com
TRIP	TripAdvisor
TGI	Triumph
TFC	Truist Financial
TRQ	Turquoise Hill F
TWLO	Twilio
TWTR	Twitter
TWO	Two Harbors In
TSN	Tyson Foods
UBER	Uber
ULTA	Ulta Beauty
UCTT	Ultra Clean Hol
UGP	Ultrapar Partici
UAA	Under Armour
UA	Under Armour (
UNP	Union Pacific
UAL	United Continel
UMC	United Microele
X	United States S
UTX	United Technol
UNH	UnitedHealth
UNIT	Uniti Group
UNM	Unum Group
TIGR	UP Fintech
UPS	UPS
URBN	Urban Outfitter
USB	US Bancorp
SLCA	US Silica Holdir
UXIN	Uxin
VALE	Vale
VLO	Valero
VGR	Vector Group
VEEV	Veeva Systems
VTR	Ventas
VER	Vereit
VRSN	Verisign
VRSK	Verisk Analytic
VZ	Verizon
VRTX	Vertex Pharma
VFC	VF Corporation
VIACA	ViacomCBS
VICI	VICI Properties
VIPS	Vipshop Holdin
SPCE	Virgin Galactic
V	Visa
VST	Vistra Energy
VMW	VMware
VG	Vonage Holding
WAB	WABTEC Corpc
WBA	Walgreens Boo
WMT	Walmart
DIS	Walt Disney
WM	Waste Manage!
W	Wayfair
WB	Weibo
WFC	Wells Fargo
WELL	Welltower
WEN	Wendy's Comp:
WDC	Western Digital
WU	Western Union
WRK	WestRock
WEX	WEX
WY	Weyerhaeuser !
WLL	Whiting Petrole
WMB	Williams Comp
WING	Wingstop
WIT	Wipro
WDAY	Workday
WWE	World Wrestlin
WPG	WP Glimcher
WPX	WPX Energy
WYNN	Wynn Resorts
XEL	Xcel Energy
XRX	Xerox
XLNX	Xilinx
AUY	Yamana Gold
YPF	YPF
YUM	Yum!
YUMC	Yum!
YY	YY
ZAYO	Zayo Group Ho!
ZBRA	Zebra Technolc
ZEN	Zendesk
Z	Zillow Group
ZBH	Zimmer Biomet
ZION	Zions Bancorpc
ZTS	Zoetis
ZM	Zoom
ZS	Zscaler
ZTO	ZTO Express
ZNGA	Zynga